11111111111111111111111111111111
1PCSSSSSSSSSSSSSSSSSSSSSSSSSSSS1
1SSSSSSSSSSSSSSSSSSSSSSSSSSSSSS1
1SSSSSSSSSSSSSSSSSSSSSSSSSSSSSS1
1SSSSSSSSSSSSSSSSSSSSSSSSSSSSSS1
1SSSSSSSSSSSSSSSSSSSSSSSSSSSSSE1
11111111111111111111111111111111
