11111
1P001
1E111
1C001
11111
