1111111111
1110001111
1000000001
1001101001
10011000P1
1000000EC1
1000000001
1011111101
1000000001
1000000011
100C010001
10C0010001
10C0010001
100C0100C1
1100000011
1111111111
