1111111111111
1111101011111
111100E001111
1110CCPCC0111
11S000C00SC11
111000C000111
1111010101111
1111100011111
1111111111111
