11111111111111
1            1
1 1111111111 1
1 100000P001 1
1 1E00000001 1
1 100C000001 1
1 1111111111 1
1            1
11111111111111
