1111111111
100000P001
1E00000001
100C000001
1111111111
